AFD15157FB
C3FEFAFF96
FC3FD4152F
BFC3FFAFC3
87FC1507FE
AFBFEFAFFF
852FFFAFFF
AFC57FAFFF
853FF943F9
EFC556FC56

0,0
9,8

SESESESEEESSSSESEEN
