3D15515153
AFEFFAFAFA
C3FFD6FAD2
FC553F96FA
97FF852FD6
AFBFEFAFFF
AFAFFFAFFF
85053FAFFF
AFAFEFAFFB
C7C5554554

0,0
9,9

SSESEEESEESSSSSEEE
