43FBF9553F
FC5456FFC3
BFBFBF97FA
85052FAFFA
EFAF854556
F96FEFBFFF
96FFFFAFFF
AFFFBFAFFF
AFF94143F9
C556FEFC56

0,0
9,8

ESEEEENEEESESSSWWWWWNWWSSWSWSSSEEENEEEESEEN
