3F95155153FD3F953FFB
AD6FAFFAFC3FC16FC552
AF956BFC7FAFFAFBFBFA
C56FFC3FFBC156F85696
BF953F8516FEFD16FFAF
AFEF87AFAFBFBFAFF96B
85156FAFC141456F96FA
AFAFF943FEFAFFF96FD2
EFC516FEFFFAFFFAFBFA
953FEFBF97FAFFFAF852
AFC3F9452F943FFC56FA
C3FC56FF852FC157FBFA
FC3FFD156FEFFEF95456
BF853FEFF9515152FBFB
C56FC55556FEFEFC5454

SOLUTION=SSSEENEENNEEEEESESSEEENNENEESEEESSWSSWSWSWSSSEENEESSSWWWWSSEEEE
