853D1553FB
EFAFEFF852
FBC3FBFEFA
96F8505152
AF96FEFEFE
852FFFFFFF
AFEFFFFFFF
C3FFBFFFFF
F85143F951
D6FEFC56FE

0,0
9,8

EESSESSWSWWSSESEEEESEENEE
