AFBFFF9553
AD43FD6FFA
AFF853F952
AD16FAFEFA
AFAF941556
C56FEFAFFF
BFBFFFAFFF
85453FAFFF
AFBFC543F9
C5457FFC56

0,0
9,8

SSSSSEENNENEESSESSSSESEEN
